***************************************************
*    *            **    ******    * *        **   *
*    *            **      **      * *  *          *
*    *    A        *       *      * *  *          *
*                  *   *   *     ** ****      A   *
*   **********     *   *   *     **        *      *
*   *        *     *   *         *         *      *
*   *   *    *         *******   *    *    *   *  *
*       *          *         *        *    *   *  *
*                                                 *
***************************************************